r300-300-400-400-
m100-100-
m200-200-
m500-500-
m600-600-
m700-700-
m800-800-
m900-900-